▇▇▇▇▇▇▇▇▇▇▇▇▇▇▇▇▇▇▇▇▇▇▇▇▇▇▇
█         ▛▀▀▀▀▀▜ ▛▀▀▀▀▀▜ █
█         ▌KHU A▐ ▌KHU B▐ █
█ ▛▀▀▀▀▀▜ ▙▄▄▄▄▄▟ ▙▄▄▄▄▄▟ █
█ ▌KHU  ▐         ▛▀▀▀▀▀▜ █
█ ▌HÀNH ▐[Sân thể ▌KHU C▐ █
█ ▌CHÍNH▐  thao]  ▙▄▄▄▄▄▟ █
█ ▌& CĂN▐         ▛▀▀▀▀▀▜ █
█ ▌TIN  ▐ ▛▀▀▀▀▀▜ ▌KHU D▐ █
█ ▙▄▄▄▄▄▟ ▌KHU F▐ ▙▄▄▄▄▄▟ █
█         ▙▄▄▄▄▄▟ ▛▀▀▀▀▀▜ █
█   [Nhà xe]      ▌KHU E▐ █
█                 ▙▄▄▄▄▄▟ █
▇▇▇▇▇▇▇▇▇▇▇▇▇▇▇▭▭▇▇▇▇▇▇▇▇▇▇